I	Backing-B
attended	Backing-I
a	Backing-I
single	Backing-I
sex	Backing-I
high	Backing-I
school	Backing-I
some	Backing-I
40	Backing-I
years	Backing-I
ago	Backing-I
.	Backing-I
Granted	O
that	O
was	O
a	O
different	O
day	O
but	O
still	O
I	O
cherish	O
the	O
memory	O
.	O
Adolescence	Premise-B
is	Premise-I
hard	Premise-I
enough	Premise-I
without	Premise-I
having	Premise-I
to	Premise-I
try	Premise-I
learning	Premise-I
in	Premise-I
an	Premise-I
environment	Premise-I
of	Premise-I
hormone-laced	Premise-I
competition	Premise-I
and	Premise-I
distraction	Premise-I
.	Premise-I
If	Claim-B
I	Claim-I
had	Claim-I
teen-aged	Claim-I
children	Claim-I
today	Claim-I
I	Claim-I
would	Claim-I
seek	Claim-I
out	Claim-I
single-sex	Claim-I
education	Claim-I
for	Claim-I
them	Claim-I
without	Claim-I
hesitation	Claim-I
.	Claim-I
