I	Backing-B
went	Backing-I
to	Backing-I
both	Backing-I
,	Backing-I
public	Backing-I
and	Backing-I
private	Backing-I
.	Backing-I
The	Premise-B
essential	Premise-I
difference	Premise-I
were	Premise-I
the	Premise-I
students	Premise-I
.	Premise-I
And	Premise-I
it	Premise-I
makes	Premise-I
all	Premise-I
the	Premise-I
difference	Premise-I
.	Premise-I
The	Claim-B
public	Claim-I
school	Claim-I
was	Claim-I
a	Claim-I
joke	Claim-I
.	Claim-I
