BIG	O
E	O
.	O
what	Premise-B
about	Premise-I
all	Premise-I
the	Premise-I
money	Premise-I
we	Premise-I
do	Premise-I
send	Premise-I
to	Premise-I
our	Premise-I
schools	Premise-I
.	Premise-I
does	Premise-I
it	Premise-I
help	Premise-I
our	Premise-I
child	Premise-I
.	Premise-I
no	Premise-I
.	Premise-I
teachers	Premise-I
keep	Premise-I
asking	Premise-I
for	Premise-I
more	Premise-I
with	Premise-I
no	Premise-I
difference	Premise-I
in	Premise-I
teaching	Premise-I
just	Premise-I
more	Premise-I
money	Premise-I
and	Premise-I
if	Premise-I
they	Premise-I
dont	Premise-I
get	Premise-I
it	Premise-I
what	Premise-I
happens	Premise-I
they	Premise-I
strike	Premise-I
.	Premise-I
well	O
thats	O
real	O
nice	O
on	O
kids	O
education	O
is	O
it	O
not	O
boo	O
hoo	O
you	O
TAKE	Claim-B
YOUR	Claim-I
KIDS	Claim-I
PRIVATE	Claim-I
IF	Claim-I
YOU	Claim-I
CARE	Claim-I
AS	Claim-I
I	Claim-I
DID	Claim-I
