I	Premise-B
believe	Premise-I
in	Premise-I
discipline	Premise-I
,	Premise-I
accountability	Premise-I
,	Premise-I
and	Premise-I
excellence	Premise-I
.	Premise-I
These	Premise-I
things	Premise-I
are	Premise-I
not	Premise-I
attainable	Premise-I
in	Premise-I
public	Premise-I
schools	Premise-I
because	Premise-I
the	Premise-I
poor	Premise-I
teachers	Premise-I
and	Premise-I
administrators	Premise-I
are	Premise-I
worried	Premise-I
about	Premise-I
getting	Premise-I
sued	Premise-I
by	Premise-I
the	Premise-I
parents	Premise-I
for	Premise-I
everything	Premise-I
.	Premise-I
The	Claim-B
public	Claim-I
school	Claim-I
system	Claim-I
the	Claim-I
way	Claim-I
it	Claim-I
is	Claim-I
now	Claim-I
is	Claim-I
not	Claim-I
an	Claim-I
option	Claim-I
.	Claim-I
Plus	Premise-B
,	Premise-I
I	Premise-I
live	Premise-I
in	Premise-I
a	Premise-I
right	Premise-I
wing	Premise-I
state	Premise-I
whose	Premise-I
legislators	Premise-I
take	Premise-I
books	Premise-I
out	Premise-I
of	Premise-I
libraries	Premise-I
on	Premise-I
religious	Premise-I
grounds	Premise-I
and	Premise-I
who	Premise-I
tried	Premise-I
to	Premise-I
remove	Premise-I
teaching	Premise-I
the	Premise-I
theory	Premise-I
of	Premise-I
evolution	Premise-I
.	Premise-I
Nope	Claim-B
,	Claim-I
public	Claim-I
school	Claim-I
not	Claim-I
for	Claim-I
me	Claim-I
!	Claim-I
