I	Premise-B
sent	Premise-I
my	Premise-I
kid	Premise-I
to	Premise-I
private	Premise-I
school	Premise-I
so	Premise-I
that	Premise-I
she	Premise-I
could	Premise-I
get	Premise-I
a	Premise-I
better	Premise-I
education	Premise-I
.	Premise-I
She	Backing-B
was	Backing-I
at	Backing-I
a	Backing-I
public	Backing-I
school	Backing-I
that	Backing-I
was	Backing-I
90%	Backing-I
hispanic	Backing-I
.	Backing-I
The	Premise-B
problem	Premise-I
was	Premise-I
not	Premise-I
their	Premise-I
race	Premise-I
but	Premise-I
the	Premise-I
fact	Premise-I
that	Premise-I
they	Premise-I
were	Premise-I
way	Premise-I
behind	Premise-I
in	Premise-I
reading	Premise-I
langauge	Premise-I
and	Premise-I
math	Premise-I
.	Premise-I
This	Premise-I
situation	Premise-I
was	Premise-I
holding	Premise-I
my	Premise-I
kid	Premise-I
and	Premise-I
preventing	Premise-I
her	Premise-I
from	Premise-I
excelling	Premise-I
in	Premise-I
her	Premise-I
studies	Premise-I
.	Premise-I
Do	O
you	O
think	O
I	O
should	O
of	O
just	O
left	O
my	O
kid	O
in	O
this	O
class	O
?	O
Give	O
me	O
a	O
break	O
!	O
