Redshirting	O
a	O
trend	O
?	O
This	O
is	O
insane	O
!	O
These	Premise-B
kids	Premise-I
need	Premise-I
to	Premise-I
be	Premise-I
prepared	Premise-I
for	Premise-I
the	Premise-I
21st	Premise-I
centuary	Premise-I
global	Premise-I
economy	Premise-I
by	Premise-I
being	Premise-I
enrolled	Premise-I
in	Premise-I
a	Premise-I
local	Premise-I
second	Premise-I
language	Premise-I
immersion	Premise-I
kindergarden	Premise-I
as	Premise-I
soon	Premise-I
as	Premise-I
they	Premise-I
can	Premise-I
enroll	Premise-I
.	Premise-I
This	Premise-I
is	Premise-I
because	Premise-I
language	Premise-I
acquisition	Premise-I
therories	Premise-I
tell	Premise-I
us	Premise-I
that	Premise-I
,	Premise-I
"	Premise-I
there	Premise-I
is	Premise-I
a	Premise-I
window	Premise-I
of	Premise-I
opportunity	Premise-I
in	Premise-I
which	Premise-I
the	Premise-I
child	Premise-I
learns	Premise-I
that	Premise-I
first	Premise-I
language	Premise-I
normally	Premise-I
.	Premise-I
After	Premise-I
this	Premise-I
period	Premise-I
,	Premise-I
the	Premise-I
brain	Premise-I
becomes	Premise-I
slowly	Premise-I
less	Premise-I
plastic	Premise-I
and	Premise-I
by	Premise-I
the	Premise-I
time	Premise-I
the	Premise-I
child	Premise-I
reaches	Premise-I
adolescence	Premise-I
,	Premise-I
the	Premise-I
brain	Premise-I
cannot	Premise-I
develop	Premise-I
"	Premise-I
richly	Premise-I
and	Premise-I
normally	Premise-I
any	Premise-I
real	Premise-I
cognitive	Premise-I
system	Premise-I
,	Premise-I
including	Premise-I
language	Premise-I
.	Premise-I
"	Premise-I
http://www.cal.org/earlylang/benefits/research_notes.html	O
As	O
Larry	O
The	O
Cable	O
Guy	O
would	O
say	O
:	O
"	O
Only	O
in	O
America	O
!	O
"	O
